Abkhaz	query=Abkhazia
Abkhazian	query=Abkhazia
Afghan	query=Afghanistan
Albanian	query=Albania
Algerian	query=Algeria
American Samoan	query=American Samoa
Andorran	query=Andorra
Angolan	query=Angola
Anguillan	query=Anguilla
Antiguan	query=Antigua and Barbuda
Barbudan	query=Antigua and Barbuda
Argentine	query=Argentina
Argentinean	query=Argentina
Argentinian	query=Argentina
Armenian	query=Armenia
Aruban	query=Aruba
Australian	query=Australia
Austrian	query=Austria
Azerbaijani	query=Azerbaijan
Azeri	query=Azerbaijan
Bahamian	query=Bahamas
Bahraini	query=Bahrain
Bangladeshi	query=Bangladesh
Barbadian	query=Barbados
Bajan	query=Barbados
Belarusian	query=Belarus
Belgian	query=Belgium
Belizean	query=Belize
Beninese	query=Benin
Beninois	query=Benin
Bermudian	query=Bermuda
Bermudan	query=Bermuda
Bhutanese	query=Bhutan
Bolivian	query=Bolivia
Bosnian	query=Bosnia and Herzegovina
Bosniak	query=Bosnia and Herzegovina
Herzegovinian	query=Bosnia and Herzegovina
Motswana	query=Botswana
Batswana	query=Botswana
Botswanan	query=Botswana
Brazilian	query=Brazil
British Virgin Island	query=British Virgin Islands
Bruneian	query=Brunei
Bulgarian	query=Bulgaria
Burkinabè	query=Burkina Faso
Burkinabe	query=Burkina Faso
Burkinabé	query=Burkina Faso
Burmese	query=Burma
Burundian	query=Burundi
Cambodian	query=Cambodia
Cameroonian	query=Cameroon
Canadian	query=Canada
Caymanian	query=Cayman Islands
Central African	query=Central African Republic
Chadian	query=Chad
Chilean	query=Chile
Christmas Island	query=Christmas Island
Cocos Island	query=Cocos (Keeling) Islands
Colombian	query=Colombia
Comorian	query=Comoros
Cook Island	query=Cook Islands
Cook Islands	query=Cook Islands
Costa Rican	query=Costa Rica
Croatian	query=Croatia
Cuban	query=Cuba
Cypriot	query=Cyprus
Czech	query=Czech Republic
Ivorian	query=Côte d'Ivoire
Congolese	query=Democratic Republic of the Congo
Congo	query=Democratic Republic of the Congo
Danish	query=Denmark
Djiboutian	query=Djibouti
Dominican	query=Dominica
Dominican	query=Dominican Republic
Timorese	query=East Timor
Ecuadorian	query=Ecuador
Egyptian	query=Egypt
Salvadoran	query=El Salvador
English	query=England
Equatorial Guinean	query=Equatorial Guinea
Equatoguinean	query=Equatorial Guinea
Eritrean	query=Eritrea
Estonian	query=Estonia
Ethiopian	query=Ethiopia
Falkland Island	query=Falkland Islands
Faroese	query=Faroe Islands
Fijian	query=Fiji
Finnish	query=Finland
French	query=France
French Guianese	query=French Guiana
French Polynesian	query=French Polynesia
Gabonese	query=Gabon
Gambian	query=Gambia
Georgian	query=Georgia
German	query=Germany
Ghanaian	query=Ghana
Gibraltar	query=Gibraltar
British	query=Great Britain
Greek	query=Greece
Grecian	query=Greece
Hellenic	query=Greece
Greenlandic	query=Greenland
Grenadian	query=Grenada
Guadeloupe	query=Guadeloupe
Guamanian	query=Guam
Guambat	query=Guam
Guatemalan	query=Guatemala
Guinean	query=Guinea
Guinean	query=Guinea-Bissau
Guyanese	query=Guyana
Haitian	query=Haiti
Honduran	query=Honduras
Hong Kong	query=Hong Kong
Hongkongese	query=Hong Kong
Hungarian	query=Hungary
Magyar	query=Hungary
Icelandic	query=Iceland
Indian	query=India
Indonesian	query=Indonesia
Iranian	query=Iran
Persian	query=Iran
Iraqi	query=Iraq
Irish	query=Ireland
Manx	query=Isle of Man
Israeli	query=Israel
Italian	query=Italy
Italic	query=Italy
Jamaican	query=Jamaica
Japanese	query=Japan
Jordanian	query=Jordan
Kazakhstani	query=Kazakhstan
Kazakh	query=Kazakhstan
Kenyan	query=Kenya
I-Kiribati	query=Kiribati
Kosovar	query=Kosovo
Kosovan	query=Kosovo
Kuwaiti	query=Kuwait
Kyrgyzstani	query=Kyrgyzstan
Kyrgyz	query=Kyrgyzstan
Kirgiz	query=Kyrgyzstan
Kirghiz	query=Kyrgyzstan
Laotian	query=Laos
Lao	query=Laos
Latvian	query=Latvia
Lebanese	query=Lebanon
Basotho	query=Lesotho
Liberian	query=Liberia
Libyan	query=Libya
Liechtenstein	query=Liechtenstein
Lithuanian	query=Lithuania
Luxembourg	query=Luxembourg
Luxembourgish	query=Luxembourg
Macanese	query=Macau
Chinese	query=Macau
Malagasy	query=Madagascar
Malawian	query=Malawi
Malaysian	query=Malaysia
Maldivian	query=Maldives
Malian	query=Mali
Maltese	query=Malta
Marshallese	query=Marshall Islands
Martiniquais	query=Martinique
Martinican	query=Martinique
Mauritanian	query=Mauritania
Mauritian	query=Mauritius
Mahoran	query=Mayotte
Mexican	query=Mexico
Micronesian	query=Micronesia
Moldovan	query=Moldova
Monégasque	query=Monaco
Monacan	query=Monaco
Mongolian	query=Mongolia
Montenegrin	query=Montenegro
Montserratian	query=Montserrat
Moroccan	query=Morocco
Mozambican	query=Mozambique
Namibian	query=Namibia
Nauruan	query=Nauru
Nepali	query=Nepal
Nepalese	query=Nepal
Dutch	query=Netherlands
New Caledonian	query=New Caledonia
New Zealand	query=New Zealand
Nicaraguan	query=Nicaragua
Nigerien	query=Niger
Nigerian	query=Nigeria
Niuean	query=Niue
North Korean	query=North Korea
Northern Irish	query=Northern Ireland
Northern Marianan	query=Northern Marianas
Norwegian	query=Norway
Omani	query=Oman
Pakistani	query=Pakistan
Palauan	query=Palau
Palestinian	query=Palestine
Panamanian	query=Panama
Papua New Guinean	query=Papua New Guinea
Papuan	query=Papua New Guinea
Paraguayan	query=Paraguay
Chinese	query=People's Republic of China
Peruvian	query=Peru
Philippine	query=Philippines
Filipina	query=Philippines
Filipino	query=Philippines
Pitcairn Island	query=Pitcairn Island
Polish	query=Poland
Portuguese	query=Portugal
Puerto Rican	query=Puerto Rico
Qatari	query=Qatar
Southern Irish	query=Republic of Ireland
Irish	query=Republic of Ireland
Macedonian	query=Republic of Macedonia
Congolese	query=Republic of the Congo
Congo	query=Republic of the Congo
Romanian	query=Romania
Russian	query=Russia
Rwandan	query=Rwanda
Réunionese	query=Réunion
Réunionnais	query=Réunion
Reunionese	query=Réunion
Saint-Pierrais	query=Saint-Pierre and Miquelon
Miquelonnais	query=Saint-Pierre and Miquelon
Samoan	query=Samoa
Sammarinese	query=San Marino
Saudi	query=Saudi Arabia
Saudi Arabian	query=Saudi Arabia
Scots	query=Scotland
Scottish	query=Scotland
Scotch	query=Scotland
Senegalese	query=Senegal
Serbian	query=Serbia
Seychellois	query=Seychelles
Sierra Leonean	query=Sierra Leone
Singaporean	query=Singapore
Slovak	query=Slovakia
Slovenian	query=Slovenia
Slovene	query=Slovenia
Solomon Island	query=Solomon Islands
Somali	query=Somalia
Somalian	query=Somalia
South African	query=South Africa
South Korean	query=South Korea
South Ossetian	query=South Ossetia
South Sudanese	query=South Sudan
Spanish	query=Spain
Sri Lankan	query=Sri Lanka
St. Helenian	query=St. Helena
St Helenian	query=St. Helena
Kittitian	query=St. Kitts and Nevis
Nevisian	query=St. Kitts and Nevis
St. Lucian	query=St. Lucia
St Lucian	query=St. Lucia
St. Vincentian	query=St. Vincent and the Grenadines
St Vincentian	query=St. Vincent and the Grenadines
Vincentian	query=St. Vincent and the Grenadines
Sudanese	query=Sudan
Surinamese	query=Surinam
Swazi	query=Swaziland
Swedish	query=Sweden
Swiss	query=Switzerland
Syrian	query=Syria
São Toméan	query=São Tomé and Príncipe
Sao Tomean	query=São Tomé and Príncipe
Sao-Tomean	query=São Tomé and Príncipe
Taiwanese	query=Taiwan
Tajikistani	query=Tajikistan
Tanzanian	query=Tanzania
Thai	query=Thailand
Togolese	query=Togo
Tongan	query=Tonga
Trinidadian	query=Trinidad and Tobago
Tobagonian	query=Trinidad and Tobago
Tunisian	query=Tunisia
Turkish	query=Turkey
Turkmen	query=Turkmenistan
Turks and Caicos Islands	query=Turks and Caicos Islands
Tuvaluan	query=Tuvalu
Ugandan	query=Uganda
Ukrainian	query=Ukraine
Emirati	query=United Arab Emirates
Emirian	query=United Arab Emirates
British	query=United Kingdom
American	query=United States
U.S.	query=United States
Uruguayan	query=Uruguay
Uzbekistani	query=Uzbekistan
Uzbek	query=Uzbekistan
Ni-Vanuatu	query=Vanuatu
Vanuatuan	query=Vanuatu
Venezuelan	query=Venezuela
Vietnamese	query=Vietnam
Virgin Island	query=Virgin Islands
Welsh	query=Wales
Wallisian	query=Wallis and Futuna
Futunan	query=Wallis and Futuna
Sahraw	query=Western Sahara
Sahrawian	query=Western Sahara
Sahraouian	query=Western Sahara
Yemeni	query=Yemen
Zambian	query=Zambia
Zimbabwean	query=Zimbabwe
